1111111111111111111111111
1111000000000000000000001
1001100000000000000000001
1000110000000000000000001
1000011111000000000000001
1000000000000000000000001
1000000000000000000000001
1000000000000000000000001
1000000000000000000000001
1111111000000000000000001
1000011100000000000000001
1000001111000000000000001
1000000000000000000000001
1000000000000000000000001
1000000000000010000000001
1000000000000110000000001
1000000000001111100000001
1000000000001000000000001
1000000000001000000000001
1000000000001000000000001
1000000111111000000000001
1000001000001000000000001
1000000000001000000000001
1000000000001000000000001
1111111111111111111111111